{
  "start":
  {
    "level":  [
                [51, 33, 33,  0,  0,  0,  0, 33, 33, 51],
                [52, 34, 34,  0, 59, 60,  0, 34, 34, 52],
                [52,  0,  0,  0,  0,  0,  0,  0,  0, 52],
                [52,  0,  0,  0,  0,  0,  0,  0,  0, 52],
                [52, 61, 35, 35,  0,  0, 35, 63, 35, 52],
                [52,  0,  0,  0,  0,  0,  0,  0,  0,  0],
                [52, 35, 35, 62,  0,  0, 35, 35, 35, 52],
                [52,  0,  0,  0,  0,  0,  0,  0,  0, 52],
                [52,  0,  0,  0,  0,  0,  0,  0,  0, 52],
                [53, 53, 53, 53, 53, 53, 53, 53, 53, 53]
              ],
              
    "up": "none",
    "right": "room1",
    "down": "none",
    "left": "none",
    "state": 1
  },

  "room1":
  {
    "level":  [ 
                [51, 2,  19,  2,  19, 8, 47,  2, 8, 51],
                [52, 9,  20,  3,  20, 3, 48,  9,  3, 52],
                [52, 0,  0,   1,  0,  0,  0,  1,  0, 52],
                [52, 1,  0,   1,  1,  0,  0,  1,  0, 52],
                [52, 0,  0,   0,  1,  1,  0,  1,  0, 52],
                [0 , 0,  1,   1,  1,  0,  0,  0,  0, 52],
                [52, 0,  0,   0,  0,  0,  1,  1,  1, 52],
                [52, 1,  1,   1,  1,  0,  1,  0,  0, 52],
                [52, 0,  0,   0,  0,  0,  0,  0,  0, 52],
                [53, 53, 53,  53, 0,  0, 53, 53, 53, 53] 
              ],
              
    "up": "none",
    "right": "none",
    "down": "room2",
    "left": "start",
    "state": 2
  },

  "room2":
  {
    "level":  [ 
                [70, 64, 70, 66, 70, 67, 70, 68, 70, 69],
                [66, 70, 64, 70, 66, 70, 67, 70, 68, 70],
                [70, 66,  0,  0,  0,  0,  0,  0, 70, 68],
                [67, 70,  0,  0,  0,  0,  0,  0, 67,  0],
                [70, 67,  0,  0,  0,  0,  0,  0, 70, 67],
                [68, 70,  0,  0,  0,  0,  0,  0, 66, 70],
                [70, 68,  0,  0,  0,  0,  0,  0, 70, 66],
                [69, 70,  0,  0,  0,  0,  0,  0, 64,  0],
                [70, 69, 70, 68, 70, 67, 70, 66, 70, 64],
                [64, 70, 69, 70, 68, 70, 67, 70, 66, 70] 
              ],
              
    "up": "room1",
    "right": "none",
    "down": "none",
    "left": "none",
    "state": 3
  }

  
  
}
